111111111111111111111111111111111111111111111111111111111111111111111111111111111111111111111111111111111111111111111111111111111111111111111111111111111111111111111111111111111111111111111111111111111111111111111111111111111111111111111111111111111111111111111111111111111111111111111111111111111111111111111111111111111111111111111111111111111111111111111111111111111111111111111111111111111111111111111111111111111111111111111111111111111111111111111111111111111111111111111111111111111111111111111111111111111111111111111111111111111111111111111111111111111111111111111111111111111111111111111111111111111111111111111111111111111111111111111111111111111111111111111111111111111111111111111111111111111111111111
1E00000CCCCC00000C0C0C0C0C0C0C0C0C1C0C0C0C0CCCC00CCCCC00000C0C0C0C0C0C0C0C0C1C0C0C0C0CCCC00CCCCC00000C0C0C0C0C0C0C0C0C1C0C0C0C0CCCC00CCCCC00000C0C0C0C0C0C0C0C0C1C0C0C0C0CCCC00CCCCC00000C0C0C0C0C0C0C0C0C1C0C0C0C0CCCC00CCCCC00000C0C0C0C0C0C0C0C0C1C0C0C0C0CCCC00CCCCC00000C0C0C0C0C0C0C0C0C1C0C0C0C0CCCC00CCCCC00000C0C0C0C0C0C0C0C0C1C0C0C0C0CCCC00CCCCC00000C0C0C0C0C0C0C0C0C1C0C0C0C0CCCC00CCCCC00000C0C0C0C0C0C0C0C0C1C0C0C0C0CCCC00CCCCC00000C0C0C0C0C0C0C0C0C1C0C0C0C0CCCC00CCCCC00000C0C0C0C0C0C0C0C0C1C0C0C0C0CCCC00CCCCC00000C0C0C0C0C0C0C0C0C1C0C0C0C0CCCC00CCCCC00000C0C0C0C0C0C0C0C0C1C0C0C0C0CCCC00010CCCCC00000C0C0C0C0C0C0C0C0C1C0C0C0C0CCCC00CCCCC00000C0C0C0C0C0C0C0C0C1C0C0C0C0CCCC00CCCCC00000C0C0C0C0C0C0C0C0C1C011
101001010010000010100100000001010000100101001000001010010000000101000010010100100000101001000000010100001001010010000010100100000001010000100101001000001010010000000101000010010100100000101001000000010100001001010010000010100100000001010000100101001000001010010000000101000010010100100000101001000000010100001001010010000010100100000001010000100101001000001010010000000101000010010100100000101001000000010100001001010010000010100100000001010000100101001000001010010000000101000010010100100000101001000000010100001001010010000010100100000001010000100101001000001010010000000101000010010100100000101001000000010100001001010010000010100100000001010000100101001000001010010000000101000010010100100000101001000000010101
101001001010101000100100000001010000100100101010100010010000000101000010010010101010001001000000010100001001001010101000100100000001010000100100101010100010010000000101000010010010101010001001000000010100001001001010101000100100000001010000100100101010100010010000000101000010010010101010001001000000010100001001001010101000100100000001010000100100101010100010010000000101000010010010101010001001000000010100001001001010101000100100000001010000100100101010100010010000000101000010010010101010001001000000010100001001001010101000100100000001010000100100101010100010010000000101000010010010101010001001000000010100001001001010101000100100000001010000100100101010100010010000000101000010010010101010001001000000010101
1P0000000C00C0000000000000000000C00C00CCCC1000CCCC0C0C0C0C0CC00000CCCCCC000000000CCCC1000CCCC0C0C0C0C0CC00000CCCCCC000000000CCCC1000CCCC0C0C0C0C0CC00000CCCCCC000000000CCCC1000CCCC0C0C0C0C0CC00000CCCCCC000000000CCCC1000CCCC0C0C0C0C0CC00000CCCCCC000000000CCCC1000CCCC0C0C0C0C0CC00000CCCCCC000000000CCCC1000CCCC0C0C0C0C0CC00000CCCCCC000000000CCCC1000CCCC0C0C0C0C0CC00000CCCCCC000000000CCCC1000CCCC0C0C0C0C0CC00000CCCCCC000000000CCCC1000CCCC0C0C0C0C0CC00000CCCCCC000000000CCCC1000CCCC0C0C0C0C0CC00000CCCCCC000000000CCCC1000CCCC0C0C0C0C0CC00000CCCCCC000000000CCCC1000CCCC0C0C0C0C0CC00000CCCCCC000000000CCCC1000CCCC0C0C0C0C0CC00000CCCCCC000000000CCCC1000CCCC0C0C0C0C0CC00000CCCCCC000000000CCCC1000CCCC0C0C0C0C0CC00000C11
111111111111111111111111111111111111111111111111111111111111111111111111111111111111111111111111111111111111111111111111111111111111111111111111111111111111111111111111111111111111111111111111111111111111111111111111111111111111111111111111111111111111111111111111111111111111111111111111111111111111111111111111111111111111111111111111111111111111111111111111111111111111111111111111111111111111111111111111111111111111111111111111111111111111111111111111111111111111111111111111111111111111111111111111111111111111111111111111111111111111111111111111111111111111111111111111111111111111111111111111111111111111111111111111111111111111111111111111111111111111111111111111111111111111111111111111111111111111111111