1111111111111111111111111111111111
1E0000000000000C00000C000000000001
1010010100100000101001000000010101
1010010010101010001001000000010101
1P0000000C00C0000000000000000000C1
111110C000CCC0111100111C0111011011
1CC00000CC000000011111110001110001
11111100000C0000000001100000111111
111111C111111111111111011111111111
11000000C000000000CCCCC00000000C01
1111111111111111111111111111111111