111111111111111
110CE0010000011
11000000CCCP001
111111111111111