11111111111111111111111111111111111111111111111111111111111111111111111111111111111111111111111111111111111111111111111111111111111111111111111111111111111111111
100000000CCCCC00000000100CCC000000000000CCCCC000000000CCC000000000000CCCCC000000000CCC000000000000CCCCC000000000CCC000000000000CCCCC000000000CCC00000000111111111
100000000CCCCC00000000100CCC000000000000CCCCC000000000CCC000000000000CCCCC000000000CCC000000000000CCCCC000000000CCC000000000000CCCCC000000000CCC00000000111111111
100000000CCCCC00000000100CCC000000000000CCCCC000000000CCC000000000000CCCCC000000000CCC000000000000CCCCC000000000CCC000000000000CCCCC000000000CCC00000000111111111
100000000CCCCC00000000100CCC0000000P0000CCCCC000000000CCC000000000000CCCCC000000000CCC000000000000CCCCC000000000CCC000000000000CCCCC000000000CCC00000000111111111
100000000CCCCC00000000000CCC00000E000000CCCCC000000000CCC000000000000CCCCC000000000CCC000000000000CCCCC000000000CCC000000000000CCCCC000000000CCC00000000111111111
11111111111111111111111111111111111111111111111111111111111111111111111111111111111111111111111111111111111111111111111111111111111111111111111111111111111111111