111111111111111
111CCCE00000011
11000000CCCP001
111111111111111