1111111111111111111111111111111111
1E1010001000000C00000C000000000001
1010110110100000101001000000010101
1010110010101010001001000000010101
1P0000001C00C0000000000000000000C1
1111111111111111111111111111111111